000S0000
000_0000
0______0
0_0000_0
0_0000_0
0__000_0
00_00__0
00E00000